[
  {
    "node_ids": [
      "114:5078",
      "114:4915",
      "114:5095",
      "114:5106",
      "114:5116"
    ],
    "suggested_name": "section-hero"
  },
  {
    "node_ids": [
      "114:5087",
      "114:5090",
      "114:5091"
    ],
    "suggested_name": "section-sustainability"
  },
  {
    "node_ids": [
      "114:4928",
      "114:4929",
      "114:4930",
      "114:4931",
      "114:5129",
      "114:5132",
      "114:5135",
      "114:5138"
    ],
    "suggested_name": "section-vision"
  },
  {
    "node_ids": [
      "114:4924",
      "114:4911",
      "114:4932",
      "114:5141",
      "114:5034",
      "114:5071",
      "114:4948",
      "114:4945",
      "114:5246",
      "114:5009",
      "114:5044",
      "114:4942",
      "114:5058",
      "114:4997",
      "114:5054",
      "114:4938",
      "114:5142",
      "114:5039",
      "114:5074",
      "114:4947",
      "114:5256",
      "114:4979",
      "114:5252",
      "114:5014",
      "114:5049",
      "114:5005",
      "114:4944",
      "114:5004",
      "114:5057"
    ],
    "suggested_name": "section-environment"
  },
  {
    "node_ids": [
      "114:4925",
      "114:4912",
      "114:4933",
      "114:5143",
      "114:5035",
      "114:5072",
      "114:4963",
      "114:4966",
      "114:5264",
      "114:4946",
      "114:5010",
      "114:5045",
      "114:4999",
      "114:4943",
      "114:4998",
      "114:5055",
      "114:4939",
      "114:5145",
      "114:5040",
      "114:5075",
      "114:5275",
      "114:4982",
      "114:5015",
      "114:5267",
      "114:5050"
    ],
    "suggested_name": "section-social"
  },
  {
    "node_ids": [
      "114:4926",
      "114:4913",
      "114:4934",
      "114:5144",
      "114:5036",
      "114:5073",
      "114:5280",
      "114:5285",
      "114:4970",
      "114:5011",
      "114:5046",
      "114:5069",
      "114:5288",
      "114:5070",
      "114:5056",
      "114:4941",
      "114:5147",
      "114:5042",
      "114:5077",
      "114:5021",
      "114:5291",
      "114:4988",
      "114:5052",
      "114:4991",
      "114:5031",
      "114:5298",
      "114:5302",
      "114:5043",
      "114:5309",
      "114:4994",
      "114:5053",
      "114:4940",
      "114:5146",
      "114:5041",
      "114:5076",
      "114:5319",
      "114:5324",
      "114:4985",
      "114:5018",
      "114:5051"
    ],
    "suggested_name": "section-human-resources"
  },
  {
    "node_ids": [
      "114:4927",
      "114:4914",
      "114:4935",
      "114:5148",
      "114:5037",
      "114:5327",
      "114:4973",
      "114:5047",
      "114:4936",
      "114:4937",
      "114:5038",
      "114:4976",
      "114:5337",
      "114:5048"
    ],
    "suggested_name": "section-business-organization"
  }
]